Mutations,Drug,Resistant,Susceptible,Total,PubMed Link
ahpC_C-57T,INH,1,0,1,
eis_G-10A,KAN,4,0,4,21300839[uid]
embB_D354A,EMB,1,1,2,20427375[uid]
embB_G406A,EMB,1,3,4,10639358[uid]
embB_G406D,EMB,2,2,4,10639358[uid]
embB_G406S,EMB,3,5,8,10639358[uid]
embB_H1002R,EMB,1,0,1,22646308[uid] **
embB_M306I,EMB,20,34,54,9257740[uid]
embB_M306V,EMB,18,3,21,9257740[uid]
embB_Q497K,EMB,1,2,3,10639358[uid]
embB_Q497R,EMB,8,4,12,10639358[uid]
fabG1_C-15T,INH,73,6,79,10428945[uid]
fabG1_G-17T,INH,5,1,6,14638486[uid]
fabG1_T-8C,INH,3,3,6,15793126[uid]
gidB_141_delC,SM,1,0,1,
gidB_202_delG,SM,4,7,11,
gidB_202_insGC,SM,1,1,2,
gidB_A134E,SM,1,0,1,17238915[uid]
gidB_A138T,SM,1,0,1,
gidB_A138V,SM,2,1,3,
gidB_A200E,SM,2,0,2,17238915[uid]
gidB_A80P,SM,1,0,1,24102832[uid]
gidB_G69D,SM,3,0,3,
gidB_H48N,SM,2,0,2,
gidB_L91P,SM,1,0,1,
gidB_P75L,SM,1,1,2,
gidB_R137W,SM,1,1,2,21444711[uid]
gidB_S70N,SM,1,0,1,
gidB_V65G,SM,1,0,1,
gidB_V88A,SM,2,0,2,
gyrA_A74S,CIP,2,0,2,17035499[uid]
gyrA_A90V,MOX,2,0,2,8031045[uid]
gyrA_A90V,OFX,2,0,2,8031045[uid]
gyrA_D94A,MOX,1,0,1,8031045[uid]
gyrA_D94A,OFX,1,0,1,8031045[uid]
gyrA_D94G,CIP,18,1,19,8031045[uid]
gyrA_D94G,MOX,9,4,13,8031045[uid]
gyrA_D94G,OFX,9,3,12,8031045[uid]
gyrA_D94N,MOX,1,0,1,8031045[uid]
gyrA_D94N,OFX,1,0,1,8031045[uid]
gyrA_S91P,CIP,2,2,4,8031045[uid]
gyrA_S91P,MOX,3,0,3,8031045[uid]
gyrA_S91P,OFX,3,0,3,8031045[uid]
inhA_I194T,INH,2,0,2,16495272[uid]
inhA_I21T,INH,2,0,2,14638486[uid]
inhA_S94A,INH,4,1,5,10815738[uid]
katG_1450_delC,INH,1,0,1,
katG_1910_delA,INH,1,0,1,
katG_471_delG,INH,2,0,2,
katG_L159P,INH,1,0,1,
katG_S315N,INH,2,1,3,9210694[uid]
katG_S315T,INH,195,1,196,8537659[uid]
katG_T180K,INH,1,0,1,16870753[uid]
katG_V633A,INH,1,1,2,
katG_W191R,INH,1,0,1,15793126[uid]
katG_W300C,INH,1,0,1,22646308[uid] **
katG_W328L,INH,1,0,1,9210694[uid]
katG_W90R,INH,1,0,1,
pncA_177_delC,PZA,1,0,1,
pncA_292_insAT,PZA,1,0,1,
pncA_409_delT,PZA,2,0,2,
pncA_491_insACC,PZA,1,0,1,
pncA_494_delC,PZA,1,0,1,
pncA_528_insGGCCGTCTGGC,PZA,1,0,1,
pncA_570_insCT,PZA,2,0,2,
pncA_A-11G,PZA,3,0,3,9056006[uid]
pncA_C138R,PZA,1,0,1,25336456[uid]
pncA_C14R,PZA,1,0,1,9055989[uid]
pncA_D12A,PZA,1,0,1,9055989[uid]
pncA_D136N,PZA,1,2,3,11641519[uid]
pncA_D49N,PZA,1,0,1,
pncA_D8G,PZA,1,0,1,11641519[uid]
pncA_D8N,PZA,1,0,1,25336456[uid]
pncA_G132D,PZA,1,0,1,9692180[uid]
pncA_G162D,PZA,1,0,1,17360809[uid]
pncA_G78C,PZA,1,0,1,
pncA_G97D,PZA,1,0,1,11083630[uid]
pncA_H57D,PZA,11,0,11,9056006[uid]
pncA_H57R,PZA,2,0,2,
pncA_K96T,PZA,1,0,1,9055989[uid]
pncA_L172P,PZA,1,0,1,9692180[uid]
pncA_L27P,PZA,1,0,1,17596354[uid]
pncA_L4S,PZA,4,0,4,11083630[uid]
pncA_Q10*,PZA,1,0,1,10390239[uid]
pncA_Q141*,PZA,1,0,1,11641519[uid]
pncA_S104R,PZA,2,0,2,9692180[uid]
pncA_T-12C,PZA,3,0,3,
pncA_V125G,PZA,4,0,4,18573039[uid]
pncA_V139L,PZA,1,0,1,11083630[uid]
pncA_V180F,PZA,1,0,1,11641519[uid]
pncA_V7L,PZA,3,0,3,
pncA_W68C,PZA,1,0,1,25336456[uid]
rpoB_1396_insATTC,RIF,2,0,2,
rpoB_1427_delTGGCCCC,RIF,1,0,1,
rpoB_D435F,RIF,1,0,1,16229229[uid]
rpoB_D435V,RIF,4,0,4,15184414[uid]
rpoB_H445D,RIF,6,0,6,14729930[uid]
rpoB_H445N,RIF,1,4,5,14729930[uid]
rpoB_H445R,RIF,3,0,3,9003625[uid]
rpoB_H445Y,RIF,12,0,12,8027320[uid]
rpoB_I491F,RIF,4,19,23,10565894[uid]
rpoB_L452P,RIF,4,4,8,10921994[uid]
rpoB_Q432K,RIF,1,0,1,8027320[uid]
rpoB_S431G,RIF,1,0,1,17360809[uid]
rpoB_S450F,RIF,4,0,4,15728936[uid]
rpoB_S450L,RIF,59,1,60,7946393[uid]
rpoB_S450W,RIF,3,1,4,7759399[uid]
rpoB_V170F,RIF,2,1,3,
rpoB_V262A,RIF,1,0,1,
rpoB_V359A,RIF,1,0,1,
rpsA_A440T,PZA,11,0,11,
rpsL_K43R,SM,24,0,24,7968530[uid]
rpsL_K88R,SM,11,0,11,7934937[uid]
rrs_A1401G,AK,5,0,5,8971706[uid]
rrs_A1401G,CAP,5,0,5,
rrs_A1401G,KAN,5,0,5,
rrs_A514C,SM,2,0,2,22943573[uid]
rrs_C513T,SM,2,0,2,
rrs_C517T,SM,2,0,2,15567277[uid]
tlyA_C-83T,CAP,1,0,1,
